20 72 6 45
########
###   ##
# $$.. #
#  .@# #
## #   #
## $* ##
####  ##
########