69 50 38
######
#    ###
#   .. #
# $$$@ #
#  # . #
########