30 97 87
######
#@ ..#
# #$ ##
# #   #
#  $# #
#  *  #
#######