89 92 8
######
#  . #
# #. ##
#  .  #
# $$$ #
#  # @#
#######