62 39 14
 #####
##@  ##
#  #  #
# $*$ #
#  .  #
## . ##
 #####