80 39 36
########
#@*  ###
# $#  ##
# $ . ##
#.   ###
########