85 71 57
#######
#  .  ##
# $$#. #
# #@$  #
#  .#  #
########