22 80
######
#@   #
#  $.#
# .$ #
######