33 96 1
#####
#   #
# # ###
#*.$  #
#  #$ #
#@   .#
#######