75 65
#######
#     ###
#  @$$..#
#### ## #
  #     #
  #  ####
  #  #
  ####