6 93
########
########
##  ####
# $ ####
#   .@##
## #####
## $ .##
########
########
