10 80
#########
#########
#########
#########
# $ . @ #
#   ### #
###.  $ #
#########
#########
