65 76
################
################
####.  #########
#####  #########
##### ##########
##### ##########
##### ##########
##### ##  ######
##### ## $######
##### ##  ######
#####$##  ######
##### ##  ######
##### ##  ######
##### @   ######
######### ######
#########  #####
#####.     #####
################
################
