11 59
##########
##########
##  ######
# $ .   ##
#  .##$ @#
######  ##
##########
##########
