43
############################################
############################################
############################################
############################################
############################################
#####.      $ ##############################
############# ##############################
############# ##############################
############# ##############################
#############                           @###
############################################
############################################
############################################
############################################
############################################
