39 33 9
#########
#########
###.#####
##  #####
# $.   @#
#    ####
# $   .##
#  $ ####
###  ####
#########
