83 45 52
################
################
################
################
################
################
##     @    ####
##$ ####### ####
## $####### ####
#   ####### ####
#         . ####
##  ####### ####
##  ####### ####
#   ####### ####
#            .##
########### $.##
################
################
################
