52 2
##########
###  #####
#  .$#####
#@     .##
#  #######
#  #######
# $#######
#  #######
##########
