20 20 89
########
########
###  ###
### $.##
#   .$##
# $  .##
##@   ##
########
