82 88
###########################################
###########################################
#@                              ###########
################## ########## # ###########
################## ########## # ###########
################## ########## # ###########
################## ########## # ###########
################## ########## # ###########
##################$########## # ###########
################## ########## # ###########
#################  ########## # ###########
#################                  .#######
#################            .$ ###########
#############################  ############
###########################################
###########################################
###########################################
