18 41
#########
#########
#########
#####.###
#     .##
# $##$###
##    @##
#########
