50 39
########
#   @###
# $  .##
#### ###
####$###
####  ##
##.   ##
########
########
