72
############################################
############################################
##                        @#################
## #########################################
## #########################################
## #########################################
## #########################################
## #########################################
## #########################################
##$#########################################
## #########################################
## #########################################
## #########################################
## #########################################
## #########################################
#  #########################################
#                           .###############
############################################
############################################
