47 20 49
#########
####  ###
##. $@ ##
###    ##
###  # ##
###. $ ##
###$.####
###  ####
#########
