45
####################
####################
####################
####################
####################
##      @###########
##$#################
## #################
## #################
## #################
## #################
## #################
## #################
## #################
#  #################
#   .###############
####################
####################
