87
#########################################
#########################################
#########################################
#########################################
#########################################
#########################################
#########################################
###                         .############
###  ####################################
#### ####################################
####$####################################
#### ####################################
####                                   @#
#########################################
#########################################
#########################################
#########################################
